333333333333333333333
300000100000000020003
302120202221202020223
302020002020002010003
301022122020222120203
300000000020000020203
302211202022222022203
302000202000002000003
302022202022122212203
300020002020000000103
322220222020222222203
300020001020002000003
302022202120222022223
302000200020002020003
322220222022201022203
300000202000201000203
302021202022202220203
301010000020002000003
302120222220202022223
300000000000202000003
333333333333333333333